????????????????????????????
????????????????????????????
????????????????????????????
############################
#............##............#
#.####.#####.##.#####.####.#
#.####.#####.##.#####.####.#
#.####.#####.##.#####.####.#
#..........................#
#.####.##.########.##.####.#
#.####.##.########.##.####.#
#......##....##....##......#
######.#####-##-#####.######
?????#.#####-##-#####.#?????
?????#.##----------##.#?????
?????#.##-###&&###-##.#?????
######.##-#------#-##.######
------.---#------#---.------
######.##-#------#-##.######
?????#.##-########-##.#?????
?????#.##----------##.#?????
?????#.##-########-##.#?????
######.##-########-##.######
#............##............#
#.####.#####.##.#####.####.#
#.####.#####.##.#####.####.#
#...##.......--.......##...#
###.##.##.########.##.##.###
###.##.##.########.##.##.###
#......##....##....##......#
#.##########.##.##########.#
#.##########.##.##########.#
#..........................#
############################
????????????????????????????
????????????????????????????