????????????????????????????
????????????????????????????
????????????????????????????
############################
#------------##------------#
#-####-#####-##-#####-####-#
#-####-#####-##-#####-####-#
#-####-#####-##-#####-####-#
#--------------------------#
#-####-##-########-##-####-#
#-####-##-########-##-####-#
#------##----##----##------#
######-#####-##-#####-######
?????#-#####-##-#####-#?????
?????#-##----------##-#?????
?????#-##-###&&###-##-#?????
######-##-#------#-##-######
----------#------#----------
######-##-#------#-##-######
?????#-##-########-##-#?????
?????#-##----------##-#?????
?????#-##-########-##-#?????
######-##-########-##-######
#------------##------------#
#-####-#####-##-#####-####-#
#-####-#####-##-#####-####-#
#---##----------------##---#
###-##-##-########-##-##-###
###-##-##-########-##-##-###
#------##----##----##------#
#-##########-##-##########-#
#-##########-##-##########-#
#--------------------------#
############################
????????????????????????????
????????????????????????????