????????????????????????????
????????????????????????????
????????????????????????????
############################
#............##............#
#.####.#####.##.#####.####.#
#o####.#####.##.#####.####o#
#.####.#####.##.#####.####.#
#..............c...........#
#.####.##.########.##.####.#
#.####.##.########.##.####.#
#......##....##....##......#
######.#####-##-#####.######
?????#.#####-##-#####.#?????
?????#.##----------##.#?????
?????#.##-###&&###-##.#?????
######.##-#------#-##.######
------.---#------#---.------
######.##-#------#-##.######
?????#.##-########-##.#?????
?????#.##----------##.#?????
?????#.##-########-##.#?????
######.##-########-##.######
#............##............#
#.####.#####.##.#####.####.#
#.####.#####.##.#####.####.#
#...##................##...#
###.##.##.########.##.##.###
###.##.##.########.##.##.###
#......##....##....##......#
#o##########.##.##########o#
#.##########.##.##########.#
#...........c..............#
############################
????????????????????????????
????????????????????????????